8 8 8 8 8 8 8 8 8 8 8 8 8 8 8 8 8 8 8 8
8 9 9 9 9 9 9 9 9 9 9 9 9 9 9 9 9 9 9 8
8 9 9 9 9 9 9 9 9 9 9 9 9 9 9 9 9 9 9 8
8 9 9 9 9 9 9 9 9 9 9 9 9 9 9 9 9 9 9 8
8 9 9 9 9 9 9 9 9 9 9 9 9 9 9 9 9 9 9 8
8 9 9 9 9 9 9 9 9 9 9 9 9 9 9 9 9 9 9 8
8 9 9 9 9 9 9 9 9 9 9 9 9 9 9 9 9 9 9 8
8 9 9 9 9 9 9 9 9 9 9 9 9 9 9 9 9 9 9 8
8 9 9 9 9 9 9 9 9 9 9 9 9 9 1 2 2 2 2 8
8 9 9 9 9 9 9 9 9 9 9 9 9 9 5 0 0 0 0 8
8 9 9 9 9 9 9 9 9 9 9 9 9 9 5 0 0 0 0 8
8 9 9 9 9 9 9 9 9 9 9 9 9 9 5 0 0 0 0 8
8 9 9 9 9 9 9 9 9 9 9 9 9 9 7 6 6 6 6 8
8 9 9 9 9 9 9 9 9 9 9 9 9 9 9 9 9 9 9 8
8 9 9 9 9 9 9 9 9 9 9 9 9 9 9 9 9 9 9 8
8 8 8 8 8 8 8 8 8 8 8 8 8 8 8 8 8 8 8 8