3 3 3 3 3 3 3 3 3 3 3 3 3 3 3 3 3 19 3 3 3 3 3 3 3 3 3 3 3 3 3 3 3 3 3 3 3 3 3 19 3 3 3 3 3 3 3 3 32 3 3 3 3 3 3 3 3 3 3 3 3 3 3 3 3 3 3 3 3 3 3 3 3 3 3 3 3 3 3 3 3 3 3 3 3 3 3 9 3 3 3 3 3 3 3 3 3 3 3 3 
3 3 3 9 3 3 3 3 3 19 3 3 3 3 3 3 3 3 3 3 3 3 3 3 3 3 3 3 3 3 3 3 3 3 3 3 3 3 3 3 3 3 3 3 3 3 3 3 3 3 3 3 3 3 3 3 3 32 3 3 3 3 3 3 3 3 3 3 3 3 32 3 3 3 3 3 3 9 3 3 3 3 3 3 3 3 3 3 9 3 3 3 3 3 3 9 3 3 3 3 
3 32 3 3 3 3 3 3 3 3 3 3 3 3 3 9 3 3 3 3 3 3 3 32 3 3 3 3 3 9 3 3 3 3 3 3 3 3 3 3 3 3 3 3 3 3 3 3 3 3 3 3 3 3 3 3 3 3 3 3 3 3 3 3 3 3 3 9 3 3 3 3 3 3 3 3 3 3 3 3 3 3 3 3 3 3 3 3 3 3 32 3 3 3 3 3 3 3 3 3 
3 3 3 19 3 9 3 3 32 3 3 3 3 3 3 3 3 3 3 3 3 3 3 3 3 3 3 3 32 9 3 3 3 3 3 3 3 3 3 3 19 3 3 3 3 3 3 3 3 3 3 3 3 3 3 3 3 3 3 3 3 3 3 3 3 3 3 3 32 3 3 3 3 3 3 3 3 3 3 3 3 3 3 3 3 3 3 3 3 3 3 3 3 3 3 3 3 3 3 3 
3 3 3 3 3 3 3 3 3 3 3 3 3 3 9 3 3 3 3 3 3 3 3 3 3 3 3 3 3 9 3 3 3 3 3 3 3 3 19 3 3 3 3 3 3 32 3 3 3 3 3 3 3 3 32 3 9 3 3 3 3 3 3 3 3 3 3 3 3 3 3 3 3 3 3 32 3 3 3 19 3 3 3 3 3 9 9 3 3 3 3 3 3 3 9 3 3 9 3 3 
3 3 3 3 3 3 3 3 3 3 3 19 19 3 3 3 3 3 3 3 32 3 3 3 3 9 3 3 3 3 3 3 32 3 3 3 3 9 3 3 3 3 3 9 3 3 3 3 9 3 3 3 3 3 3 3 3 3 3 3 3 3 32 3 3 3 3 3 3 3 3 3 3 3 3 3 3 3 3 3 3 3 3 3 3 32 3 3 3 3 3 3 3 3 3 3 3 3 3 3 
3 3 3 3 3 3 3 3 3 3 3 3 3 3 3 3 3 3 3 3 3 3 3 3 3 3 3 3 3 3 3 3 3 3 3 3 3 3 3 3 3 3 3 3 3 3 3 9 9 3 3 3 3 3 3 3 32 19 3 3 19 3 3 3 3 3 32 3 3 3 3 3 3 3 3 3 3 3 3 3 3 3 3 3 3 3 3 3 3 3 3 3 3 3 3 3 3 3 3 3 
3 3 3 3 32 3 3 3 3 3 3 3 3 3 3 3 3 3 3 19 3 3 3 3 3 3 3 3 3 3 3 3 3 3 3 19 3 3 3 3 3 3 3 3 3 3 3 3 3 3 3 3 3 3 3 3 3 19 3 3 3 3 3 3 3 3 3 3 3 3 3 3 3 3 3 3 3 3 3 3 3 3 3 3 3 3 3 3 3 3 3 3 3 3 3 3 3 3 3 3 
3 3 3 3 3 3 3 3 3 3 3 3 32 3 3 3 3 3 3 3 3 32 3 3 3 3 3 3 3 3 3 3 3 3 3 19 3 3 3 3 3 3 3 3 3 19 3 3 3 32 3 3 3 3 3 3 3 3 3 3 3 3 3 3 3 3 3 3 3 3 9 3 3 3 3 3 3 32 3 3 3 3 3 3 3 3 3 3 3 3 3 3 3 3 3 3 3 3 3 32  
32 3 3 3 3 3 3 3 3 3 3 3 3 3 3 3 3 3 3 3 3 32 3 3 3 3 9 9 3 3 3 3 3 3 3 3 9 9 3 3 3 3 3 3 3 3 3 3 3 3 3 3 3 3 3 3 3 3 3 3 3 3 3 3 3 3 3 3 3 3 3 3 3 3 3 3 3 9 3 3 3 9 3 3 3 3 3 3 3 3 3 3 3 3 3 3 3 3 3 3 
3 3 3 3 3 3 3 3 3 3 3 3 9 9 3 3 3 3 3 3 3 3 3 3 3 3 3 3 3 3 3 3 3 3 3 3 3 3 3 3 3 3 3 3 9 3 3 3 3 3 3 3 3 3 3 3 3 3 19 3 3 3 3 19 3 3 3 3 3 3 3 32 3 3 3 3 3 3 3 3 3 3 3 3 3 3 3 3 3 3 32 3 32 3 3 9 3 3 3 3 
3 3 3 3 3 3 3 3 3 3 3 3 3 3 3 3 3 3 3 3 3 3 3 3 3 3 3 3 3 3 3 3 3 3 3 3 3 9 9 3 3 3 3 3 3 3 3 3 3 3 3 3 3 3 3 3 3 3 3 3 19 3 3 3 3 3 3 3 3 3 3 3 3 3 3 3 3 3 3 3 3 3 3 3 3 3 3 3 3 3 19 3 3 3 3 3 3 3 3 3 
3 3 3 3 32 9 3 3 3 3 3 3 3 3 3 3 3 3 3 3 3 3 3 3 3 3 3 3 32 3 3 3 3 3 3 3 3 3 3 3 3 3 3 3 3 3 3 3 3 3 3 3 3 3 3 3 3 3 3 3 3 3 3 3 32 3 3 3 3 3 3 3 3 3 3 3 3 3 3 3 3 3 3 3 3 3 3 3 3 3 3 9 3 3 3 3 3 3 3 3 
3 3 3 3 3 9 3 3 3 3 3 3 3 3 3 3 3 3 3 3 3 3 3 3 3 3 3 3 3 3 9 9 9 3 3 3 3 3 3 3 3 3 3 3 3 3 3 3 3 3 3 3 3 3 3 3 3 3 3 9 3 3 3 3 32 3 3 3 3 3 3 3 32 3 3 3 3 3 3 32 3 3 3 3 3 3 3 3 3 3 3 3 3 3 3 3 3 3 19 3 
3 3 3 3 3 32 3 3 3 3 3 3 3 3 3 9 3 3 32 3 3 3 3 3 3 3 3 3 3 3 3 3 3 3 3 3 3 3 3 3 32 3 3 3 3 3 3 3 3 3 32 32 32 3 3 3 3 3 3 3 3 3 3 3 3 3 3 3 3 3 3 3 3 3 3 3 3 3 3 3 3 3 3 3 3 3 3 3 3 3 3 3 3 3 3 3 3 3 3 3 
3 3 3 9 3 3 3 3 3 3 3 3 3 3 3 3 3 3 3 3 3 9 3 3 3 3 3 3 3 3 3 3 3 3 3 3 3 3 3 3 3 3 3 3 3 3 9 3 3 3 3 3 3 3 3 3 3 3 3 3 3 3 3 3 3 3 3 3 3 3 3 3 3 3 3 3 3 3 3 3 3 3 3 3 3 3 3 3 3 32 3 3 3 3 3 3 3 3 3 3 
3 3 3 9 9 9 3 3 3 3 19 3 3 3 3 3 3 3 3 9 3 3 3 3 3 3 3 3 3 3 3 3 3 3 3 3 3 3 3 3 3 9 3 3 3 3 3 3 3 3 9 30 30 30 30 30 30 30 30 30 3 3 3 3 3 3 3 3 3 3 3 3 3 3 3 3 3 30 30 30 30 30 30 3 3 3 3 3 3 3 3 3 3 3 3 3 3 3 3 3 
3 3 3 3 3 3 3 3 3 3 3 3 32 3 3 3 3 3 9 9 3 3 3 3 3 3 30 30 30 30 30 3 3 3 30 30 3 3 3 3 3 3 3 3 3 3 3 3 3 30 30 7 7 7 7 7 7 7 7 7 30 30 30 30 3 3 3 32 3 3 3 3 3 30 30 30 30 7 7 7 7 7 7 30 3 3 3 3 3 3 3 3 3 3 3 3 3 19 3 3 
3 3 3 3 3 3 3 3 3 3 3 3 3 19 3 3 3 3 3 3 3 3 3 3 30 30 7 7 7 7 7 30 30 30 7 7 30 30 30 30 3 3 3 3 3 3 3 3 30 7 7 7 7 7 6 7 7 6 7 7 6 7 7 7 30 30 3 3 3 3 3 3 30 7 7 7 7 7 7 7 24 11 21 7 30 30 3 3 3 3 3 3 3 3 3 3 3 3 3 3 
3 3 9 3 3 3 3 3 3 3 3 3 3 3 3 3 3 3 3 3 3 30 30 30 7 7 7 7 7 7 7 7 7 7 7 7 7 7 7 7 30 30 3 3 3 3 3 30 7 7 7 23 26 7 7 7 7 7 7 7 7 7 7 7 7 7 30 30 3 3 30 30 7 7 7 6 7 7 7 17 22 10 4 7 7 7 30 30 3 3 3 3 3 19 3 3 3 3 32 3 
3 3 32 3 3 3 3 3 3 3 3 3 3 3 3 3 3 3 3 3 30 7 6 6 7 7 7 7 7 7 7 7 7 7 7 7 6 7 7 7 7 7 30 30 30 30 30 7 7 6 7 2 13 7 7 17 7 7 7 7 7 7 7 7 7 7 7 7 30 30 7 7 7 7 7 24 23 26 7 7 7 8 1 24 7 23 26 7 30 3 3 3 3 3 3 32 3 3 3 3 
3 3 32 3 3 3 3 3 3 3 3 3 3 3 3 3 3 3 30 30 7 7 7 7 7 7 7 7 6 7 7 7 6 7 7 7 7 7 7 7 7 7 7 7 7 7 7 7 7 7 7 12 29 6 22 22 7 7 7 7 7 7 7 7 7 6 7 7 7 7 7 7 7 7 7 7 2 13 7 7 24 17 6 7 7 2 13 7 30 3 3 3 3 3 3 3 3 3 3 3 
3 3 9 3 3 9 3 3 3 32 3 3 3 3 3 3 3 30 7 7 7 7 7 7 7 7 7 7 7 7 7 7 7 7 7 7 7 7 7 7 7 6 7 7 7 7 7 7 6 7 7 7 7 7 17 7 7 23 26 7 7 7 7 7 7 7 17 6 7 17 7 7 7 22 6 7 12 29 7 7 7 7 17 7 7 12 29 24 30 3 3 3 3 3 3 3 3 3 3 3 
3 3 3 3 3 3 3 3 3 3 3 3 3 3 30 30 30 7 7 7 7 7 7 7 24 7 7 7 23 26 7 7 7 7 7 7 7 7 6 7 7 7 7 7 7 7 7 7 7 7 7 7 7 7 7 7 7 2 13 7 7 7 6 7 7 7 23 26 7 7 7 7 7 7 24 7 7 7 11 21 7 0 7 7 7 17 6 7 30 3 3 3 3 3 3 3 3 3 3 3 
3 3 3 3 19 3 3 3 3 3 3 3 3 30 7 7 7 7 7 7 7 7 7 7 7 7 7 7 2 13 7 24 7 6 7 7 7 7 7 7 7 7 7 23 26 6 7 7 7 7 7 7 7 7 7 7 7 12 29 7 6 7 7 7 7 7 2 13 7 7 7 7 7 17 6 7 22 17 10 4 7 7 7 24 7 6 11 21 30 3 3 19 3 3 3 3 3 3 3 3 
3 3 3 3 3 3 3 3 3 3 3 3 30 7 7 7 7 7 7 7 0 7 7 7 7 7 7 7 12 29 7 7 7 7 7 7 7 7 7 7 7 7 7 2 13 7 7 17 6 6 7 7 7 7 7 7 7 7 7 7 7 7 7 7 7 7 12 29 7 7 7 7 7 7 7 7 7 7 8 1 7 24 7 23 26 7 10 4 30 3 3 3 3 3 3 3 3 3 3 3 
3 3 3 3 9 3 3 3 3 3 3 30 7 7 7 7 7 7 24 7 7 7 7 7 7 17 22 6 7 24 7 7 7 7 7 7 7 7 7 7 7 7 7 12 29 7 7 7 22 7 7 7 7 7 7 7 7 7 7 7 7 7 7 7 6 7 7 7 7 7 7 7 7 7 7 22 17 7 7 7 7 7 7 2 13 7 8 1 30 3 3 3 3 3 3 3 19 3 3 3 
3 3 3 3 3 3 3 3 3 3 3 30 7 7 7 7 7 7 23 26 7 7 7 11 21 7 17 7 7 7 7 7 7 22 6 7 7 7 7 7 7 7 7 7 7 7 7 7 7 7 7 7 7 7 7 7 7 7 7 7 7 7 7 7 22 6 6 17 7 7 7 7 7 7 7 7 17 6 24 7 7 22 22 12 29 7 7 30 3 3 3 3 3 3 3 19 3 3 3 3 
3 3 3 3 3 3 3 3 3 3 3 30 7 7 7 7 7 7 2 13 7 7 7 10 4 7 7 7 7 7 7 6 6 6 17 7 7 7 6 7 7 7 7 7 7 7 7 7 7 7 7 7 7 7 7 7 7 7 7 7 7 7 7 7 7 7 7 7 7 7 7 22 7 7 7 7 7 7 7 7 7 24 7 6 17 7 22 30 3 3 3 3 3 3 3 3 3 3 3 3 
3 3 3 3 3 3 3 3 3 3 3 3 30 7 7 7 7 7 12 29 7 7 7 8 1 7 7 7 7 7 7 7 7 7 7 7 7 7 7 7 7 7 7 6 7 7 7 6 7 7 7 7 7 7 7 7 7 7 7 7 7 7 6 6 7 7 7 7 7 7 7 7 17 7 7 7 7 7 7 7 22 7 7 7 22 7 7 30 3 3 3 3 32 3 3 3 32 3 3 3 
3 3 3 3 3 3 3 32 3 3 3 3 30 7 7 7 24 7 22 7 7 7 7 7 7 7 7 7 7 7 7 7 7 7 7 7 7 7 7 7 7 7 7 7 7 7 7 7 7 7 7 7 7 7 7 7 7 6 7 7 7 7 7 6 6 7 7 7 7 7 7 7 7 7 7 7 6 17 7 7 7 7 7 7 7 7 7 30 3 3 3 3 3 3 3 3 3 3 3 3 
3 3 3 3 3 3 3 3 3 3 3 3 30 7 7 7 7 7 7 7 24 7 7 7 7 7 22 6 24 7 7 7 7 7 7 7 7 7 7 7 7 6 7 7 7 7 7 7 7 17 7 7 6 6 7 7 7 7 7 7 7 7 7 6 7 7 7 7 7 7 7 7 7 7 7 7 7 7 7 6 7 7 7 7 7 7 30 3 3 3 3 3 3 3 3 3 3 3 3 3 
3 3 3 3 3 3 32 3 3 3 3 3 3 30 7 7 7 7 7 6 7 7 7 7 23 26 17 7 7 7 7 7 7 7 7 7 7 7 7 7 7 23 26 7 7 7 7 7 7 6 7 7 7 17 7 6 7 7 7 7 7 7 7 7 7 7 6 7 7 17 6 7 7 7 7 7 7 7 7 7 7 7 7 7 7 7 30 3 3 3 3 9 3 3 19 3 3 3 3 3 
3 32 3 3 3 3 3 3 3 3 3 32 3 3 30 7 7 7 7 7 7 7 7 7 2 13 7 7 7 7 7 7 7 6 6 22 7 7 7 7 7 2 13 7 7 7 7 7 7 7 7 7 7 7 7 7 7 7 7 7 7 6 7 7 7 7 7 7 7 7 7 7 7 7 7 7 7 7 7 7 23 26 6 7 7 30 3 3 3 3 3 3 3 3 3 3 3 3 3 3 
3 3 3 3 3 3 9 3 3 9 3 3 3 3 3 30 7 7 7 7 7 7 7 7 12 29 6 7 7 7 7 7 7 7 7 17 7 7 7 7 7 12 29 7 7 7 7 7 7 7 7 7 7 7 7 7 7 7 7 7 7 7 7 7 7 7 7 7 7 7 7 7 7 22 6 7 7 7 7 7 2 13 17 7 7 30 3 19 3 3 3 3 3 3 3 3 3 3 3 3 
3 3 3 3 3 3 3 3 3 3 3 3 3 3 3 30 7 7 7 7 7 24 7 7 7 7 7 7 7 7 7 7 7 7 7 7 7 7 7 7 7 6 7 7 7 7 7 7 7 7 7 7 7 7 7 7 7 7 7 7 7 7 7 7 7 7 7 7 7 7 7 7 22 17 7 7 7 7 7 7 12 29 7 7 30 3 3 3 3 3 3 3 3 3 3 9 3 3 3 3 
3 3 3 32 3 3 3 9 3 3 3 3 3 3 3 3 30 7 7 7 7 7 7 7 7 7 7 7 7 7 22 17 7 7 7 7 7 7 6 7 7 7 7 7 6 6 7 7 7 7 7 7 7 7 7 7 7 7 7 7 17 17 7 7 7 7 7 7 7 7 7 7 7 7 7 7 7 7 22 17 7 7 7 7 30 3 3 3 3 3 3 3 3 19 3 3 3 3 9 3 
3 3 3 9 9 3 3 3 3 3 3 3 3 3 3 3 3 30 7 7 7 7 7 7 7 7 7 7 7 7 7 7 7 7 7 7 7 22 22 6 7 7 7 7 7 7 6 7 7 7 7 7 7 7 7 7 7 7 22 22 17 17 6 7 7 7 7 7 6 7 7 7 7 7 7 7 7 7 7 6 7 7 7 30 3 3 3 3 3 3 3 3 3 3 3 3 3 3 9 3 
3 32 3 3 3 3 3 3 3 3 32 3 3 3 3 3 3 30 7 7 7 22 7 7 7 7 7 7 7 7 7 6 7 7 7 7 7 17 7 7 7 6 17 7 7 7 7 7 7 7 7 7 7 7 7 7 7 7 7 7 7 22 7 7 7 7 7 7 7 6 7 7 7 7 7 6 7 7 7 7 7 7 7 30 3 3 3 3 32 3 3 3 3 3 9 3 3 3 19 3 
3 3 3 3 3 3 3 3 3 3 9 3 3 3 3 3 3 3 30 7 6 17 7 7 7 7 7 7 6 7 7 7 7 7 7 7 7 7 7 7 7 22 7 7 6 6 6 7 7 7 7 7 7 7 7 7 7 7 7 7 23 26 7 7 7 7 7 7 7 7 7 7 7 7 7 7 7 7 7 7 17 22 6 30 3 3 9 3 3 3 3 3 3 3 3 3 3 3 3 3 
3 3 3 3 3 3 32 3 3 3 3 3 3 3 3 3 3 3 30 7 7 7 7 7 7 7 7 7 7 7 7 7 6 22 7 7 7 7 7 7 7 7 7 7 7 7 7 7 7 7 7 7 7 7 7 7 7 7 7 7 2 13 7 7 7 7 7 7 7 7 7 7 7 7 7 7 7 7 7 7 7 7 7 30 3 3 3 3 3 3 3 3 3 3 3 3 3 3 3 3 
3 3 3 3 3 3 3 3 3 3 3 3 3 3 3 3 9 3 3 30 7 7 7 7 7 7 7 7 7 7 7 7 7 17 7 7 7 7 7 7 7 7 7 7 7 7 7 7 7 7 7 7 7 7 6 7 7 7 7 7 12 29 7 7 7 7 7 7 7 22 7 7 7 7 7 7 7 7 7 7 7 17 7 30 3 3 3 3 3 3 3 3 3 9 3 3 3 3 3 3 
3 9 3 3 3 3 3 3 3 3 3 3 3 3 3 3 3 3 3 3 30 7 7 7 7 7 22 6 7 7 22 7 7 7 7 7 7 7 7 7 22 6 17 7 7 7 7 7 7 7 7 7 6 22 7 7 7 7 7 7 7 7 7 7 7 7 7 7 7 7 17 7 7 7 7 7 7 7 7 7 7 6 22 30 3 3 3 3 3 3 3 3 3 3 3 3 3 32 3 3 
3 3 3 3 3 3 3 3 3 3 3 3 3 3 3 3 3 3 3 30 7 7 7 7 7 7 7 17 7 7 7 7 7 7 7 7 7 7 7 7 7 7 7 7 7 7 7 17 6 7 7 7 7 17 22 7 7 7 22 7 7 7 7 7 6 7 7 7 7 7 7 7 7 23 26 7 7 7 7 7 7 7 7 30 3 3 3 3 3 3 3 3 3 3 3 3 3 3 3 3 
3 32 3 3 9 3 3 3 3 3 3 3 3 3 3 3 3 3 3 30 7 7 7 7 7 7 7 7 23 26 7 7 6 7 7 7 7 7 7 7 7 7 7 7 7 7 7 7 7 7 7 7 7 7 17 7 7 17 6 7 7 7 17 17 22 7 7 7 7 7 7 7 7 2 13 7 6 22 7 7 7 7 7 30 3 3 3 3 3 3 3 3 3 3 3 3 3 19 3 3 
3 3 3 3 3 3 3 9 9 3 32 3 3 3 32 3 3 3 3 30 7 7 7 22 17 7 7 7 2 13 7 7 7 7 7 7 7 7 23 26 7 7 7 7 17 7 7 7 7 7 7 7 7 7 7 7 7 7 7 7 7 7 7 7 7 7 7 7 7 7 7 17 7 12 29 7 7 17 7 7 7 7 7 30 3 3 3 3 3 19 9 3 3 3 3 3 3 3 3 3 
3 3 3 9 3 3 3 3 3 9 3 3 3 3 3 3 3 3 3 30 7 7 7 7 7 7 7 7 12 29 7 7 7 7 7 7 7 7 2 13 6 22 7 7 7 7 7 7 7 7 17 7 7 7 7 7 22 7 7 7 7 7 7 7 7 7 7 6 7 7 7 6 22 7 7 7 7 7 7 7 7 17 6 30 3 3 3 3 3 3 3 3 3 3 3 3 3 3 3 3 
3 3 3 3 3 3 3 3 3 3 3 3 3 3 3 3 3 3 3 30 7 7 7 7 7 7 7 7 7 7 7 7 7 7 7 7 7 7 12 29 7 7 7 7 7 7 7 7 7 7 6 7 7 7 22 7 7 7 7 7 7 7 7 7 7 7 17 22 7 7 7 7 7 7 7 7 7 7 7 7 7 7 22 7 30 3 3 3 3 3 3 3 3 3 3 3 3 3 3 3 
3 3 3 3 3 3 3 3 3 3 3 3 3 9 3 3 3 3 30 7 7 7 7 7 7 7 7 17 17 7 7 7 7 7 7 7 7 7 7 17 7 7 7 7 7 7 7 7 7 7 7 7 7 7 7 7 7 6 7 7 7 7 7 7 7 6 17 7 7 7 7 7 7 7 7 7 7 7 7 7 7 7 6 7 30 3 3 3 32 3 3 3 3 3 3 3 3 3 3 3 
3 3 3 3 3 3 3 3 3 3 3 3 3 3 3 3 30 30 7 7 7 7 7 7 7 7 7 7 17 17 7 7 7 7 7 7 7 7 6 22 7 6 17 7 7 7 7 7 28 28 34 28 28 7 7 7 7 17 22 7 7 7 7 7 7 7 7 7 7 22 7 7 7 7 6 7 7 7 7 7 7 7 7 7 7 30 3 3 3 3 3 3 3 3 3 3 3 3 9 3 
3 3 3 3 3 3 3 32 3 3 3 3 3 32 3 30 7 7 7 7 7 6 22 22 7 7 7 7 7 7 7 7 7 7 7 7 7 7 7 7 7 7 7 7 7 7 7 7 28 5 34 34 28 7 7 7 7 7 7 7 7 7 7 7 7 7 7 7 7 7 7 7 7 7 7 7 7 7 6 7 7 7 7 7 7 30 3 3 3 3 3 3 3 3 3 9 3 3 3 3 
3 3 9 19 9 3 3 3 3 3 3 3 3 3 30 7 7 7 7 7 7 7 23 26 7 7 7 7 7 22 7 7 7 7 7 7 7 7 7 7 7 17 6 6 17 7 7 7 34 34 34 34 34 7 7 7 7 7 7 7 7 7 7 7 7 7 7 7 7 7 7 7 7 7 7 7 7 7 7 7 7 22 17 7 7 30 3 3 3 3 3 3 3 3 3 3 3 3 3 3 
3 3 3 3 3 3 3 3 3 3 3 3 3 3 30 7 7 7 7 7 7 7 2 13 7 7 7 7 7 7 7 17 6 7 7 7 7 6 7 7 7 7 22 7 7 7 7 7 28 34 34 34 28 7 7 7 7 7 7 7 7 7 7 7 7 7 7 7 7 7 7 7 7 7 7 7 7 7 7 7 7 7 7 7 7 7 30 3 3 3 3 19 3 3 3 3 3 3 3 3 
3 3 3 3 3 3 3 3 3 9 3 3 3 3 30 6 7 7 7 7 6 22 12 29 7 7 7 7 7 7 22 7 7 7 7 7 7 7 7 7 7 7 7 7 7 7 7 7 28 28 34 28 28 17 7 7 7 7 7 7 7 7 7 7 7 7 7 7 7 7 17 7 7 7 7 7 7 7 7 7 7 7 7 7 7 7 30 3 3 3 3 3 3 3 3 3 3 3 3 3 
3 3 3 3 3 3 3 3 3 3 3 3 3 30 7 22 22 7 7 7 7 17 7 7 7 6 22 7 7 7 7 7 7 7 23 26 7 7 7 7 7 7 7 7 7 7 7 7 7 7 7 7 7 7 7 17 7 7 7 7 7 7 7 7 7 7 7 7 7 22 6 7 7 7 7 7 7 7 7 7 7 7 7 7 7 7 30 3 3 3 3 3 3 3 3 3 3 3 3 3 
3 3 9 3 3 3 3 3 3 3 3 3 3 30 7 7 7 7 7 7 7 7 7 7 7 7 7 7 7 7 6 7 7 7 2 13 7 7 7 22 6 17 7 7 7 7 7 7 7 17 6 7 7 7 7 7 7 7 7 7 7 7 7 7 7 7 7 7 7 7 7 7 7 7 7 7 7 7 7 7 7 7 17 22 7 7 30 3 3 3 3 3 9 3 3 3 3 3 3 3 
3 3 3 32 3 3 19 3 3 3 3 3 3 30 7 7 7 7 7 7 17 6 7 7 7 7 7 7 7 7 7 7 7 7 12 29 7 7 7 7 22 7 7 7 7 17 22 7 7 7 7 7 7 6 7 7 7 7 6 22 22 22 7 7 7 7 23 26 7 7 7 7 7 7 7 7 17 6 22 7 7 7 7 7 7 7 30 3 3 3 3 3 3 3 3 3 32 3 3 3 
3 3 3 3 3 3 3 3 3 3 3 3 3 30 17 6 7 7 7 7 7 7 7 7 7 7 7 7 7 7 7 7 7 7 7 7 7 7 7 7 7 7 7 7 7 7 7 7 7 7 7 7 7 7 7 7 7 7 7 22 22 7 7 7 7 7 2 13 7 7 7 7 7 7 7 7 7 7 7 7 7 7 7 7 7 7 7 30 3 3 3 3 3 3 3 3 3 3 3 3 
3 3 3 3 3 3 3 3 32 3 3 3 3 30 7 7 7 17 22 7 7 7 7 7 7 6 6 17 7 17 6 7 22 7 7 7 7 7 7 7 7 7 7 7 7 7 7 7 7 7 7 7 7 6 17 7 7 7 6 6 7 7 7 7 7 7 12 29 7 7 7 7 17 22 22 7 7 7 7 7 7 7 7 7 7 7 7 7 30 3 3 3 3 3 3 3 3 3 3 3 
3 3 3 3 3 3 3 3 9 3 3 3 3 30 7 7 7 7 7 7 7 7 7 7 7 7 7 7 7 7 7 7 7 7 7 6 7 7 7 7 7 7 7 7 7 7 7 7 7 17 22 7 7 7 7 7 7 7 7 17 7 7 7 7 7 7 7 7 7 7 7 7 7 7 7 7 23 26 7 7 7 7 17 7 7 7 7 7 30 3 3 3 3 3 3 3 9 3 3 3 
3 3 3 3 3 3 3 3 3 3 3 3 3 3 30 7 7 7 7 7 7 7 7 7 17 7 7 7 7 7 7 7 7 7 7 7 17 17 7 7 7 7 7 7 7 7 7 7 7 7 7 7 7 7 22 6 7 7 7 7 7 7 7 7 7 7 7 7 7 7 7 7 7 7 6 7 2 13 7 7 7 7 7 7 7 7 7 7 7 30 3 3 3 3 3 3 3 3 3 3 
3 3 3 9 32 3 3 3 3 3 3 3 3 3 30 7 7 7 7 7 7 7 7 7 7 7 7 7 7 7 7 7 7 7 7 7 7 7 7 7 7 7 7 7 7 7 7 7 7 7 7 7 7 7 7 6 17 7 7 7 7 7 7 7 7 7 7 6 7 7 7 7 7 7 7 7 12 29 7 7 7 7 7 7 7 7 22 7 7 30 3 3 3 3 3 3 3 3 3 3 
3 3 3 3 3 3 3 32 3 3 3 3 3 3 3 30 7 7 7 7 7 7 7 7 23 26 22 17 17 7 7 7 7 7 7 7 6 7 17 6 7 7 7 7 6 6 7 7 7 22 7 7 7 7 7 23 26 7 7 7 7 7 7 7 7 7 7 7 7 7 7 7 7 7 7 7 7 7 7 7 7 7 6 22 7 7 7 7 7 7 30 3 3 3 3 3 19 9 3 3 
3 3 3 3 3 3 3 3 3 3 3 3 3 3 3 30 7 7 7 20 7 7 7 7 2 13 7 7 7 7 7 7 7 7 7 7 17 7 7 22 7 7 7 7 7 7 7 7 6 17 22 7 7 7 7 2 13 7 7 7 7 7 7 7 7 6 7 7 7 7 7 7 7 7 7 7 7 7 7 7 6 22 7 7 7 7 7 7 7 7 30 3 3 3 3 3 3 3 3 3 
3 3 3 3 3 3 3 3 3 3 3 3 3 3 3 3 30 7 7 7 22 7 7 7 12 29 7 7 7 7 7 17 6 22 7 7 7 7 7 23 26 7 7 7 7 7 7 7 7 7 22 7 7 7 7 12 29 7 7 7 7 7 7 7 7 7 7 7 7 7 22 7 7 7 7 7 6 7 7 7 7 23 26 7 7 7 7 7 7 7 30 3 3 3 3 3 3 3 3 3 
3 3 3 3 3 3 19 3 3 3 3 3 19 3 3 3 3 30 7 7 7 7 7 7 17 7 7 7 7 20 7 7 17 7 7 7 7 7 7 2 13 7 7 7 7 7 7 7 7 6 7 7 7 7 7 7 17 22 7 7 7 7 7 7 7 7 7 7 7 7 17 7 6 7 7 7 22 7 7 6 7 2 13 17 6 17 7 7 17 22 30 3 3 3 9 3 3 3 3 3 
3 9 3 3 3 3 9 3 3 3 32 3 3 3 3 3 3 30 7 7 7 7 7 7 22 7 7 7 7 7 7 7 7 7 7 22 6 7 7 12 29 7 7 7 7 7 7 7 7 7 7 7 7 7 7 7 7 7 7 7 7 7 7 7 7 7 7 7 7 7 7 7 7 7 7 7 7 7 6 17 7 12 29 7 22 7 7 7 7 7 30 3 3 3 3 3 3 3 3 3 
3 3 3 3 3 3 3 3 3 3 3 3 3 3 3 3 3 30 7 7 22 7 20 7 7 7 7 17 7 7 7 7 7 7 7 7 17 17 6 7 7 7 7 7 7 7 7 17 22 7 7 7 7 17 22 7 7 7 7 7 7 7 7 7 7 7 22 7 7 7 7 7 7 7 7 7 7 7 7 7 7 7 7 7 7 7 7 22 6 7 30 3 3 3 3 3 32 3 3 3 
3 3 3 3 3 3 3 3 3 3 3 3 3 3 3 3 3 30 7 7 7 7 7 7 7 7 6 22 7 7 7 7 7 7 7 7 7 7 22 7 7 7 7 7 17 22 7 7 7 7 7 7 7 7 7 7 7 7 7 7 7 7 7 7 7 6 7 7 7 7 7 7 7 22 7 7 7 7 7 7 7 7 7 7 7 7 7 7 7 30 3 3 3 3 3 3 3 3 3 3 
3 3 32 9 3 3 3 3 3 3 3 3 32 9 3 19 3 30 7 7 7 7 7 7 7 7 7 7 7 7 7 7 6 7 7 7 7 7 7 7 7 7 7 6 7 7 7 7 7 7 6 7 7 7 7 7 6 7 7 7 7 7 7 23 26 22 17 7 17 7 7 7 7 17 7 7 7 6 7 17 22 7 7 7 7 17 22 7 30 3 3 3 3 3 3 3 3 3 3 3 
3 3 3 9 32 3 3 3 9 3 3 3 3 3 3 3 30 7 7 7 7 7 7 7 7 7 7 7 7 7 7 7 7 7 7 7 7 7 7 7 7 7 7 7 7 7 7 7 7 7 7 7 7 7 7 7 7 7 7 7 7 7 7 2 13 7 7 7 22 7 7 7 7 7 7 7 6 7 7 7 7 7 17 7 7 6 7 30 3 3 3 3 3 3 3 3 3 3 3 3 
3 3 3 9 3 3 3 3 9 3 32 3 3 3 3 3 30 7 7 7 20 7 22 7 7 7 7 20 7 7 7 7 7 7 6 7 7 7 7 7 7 7 7 7 7 7 6 7 7 7 17 7 7 7 7 22 17 7 7 7 7 7 7 12 29 7 7 7 7 7 7 7 7 17 22 7 7 7 7 7 7 7 7 7 7 7 30 3 3 9 3 3 3 19 3 3 3 3 3 3 
3 3 3 3 3 3 3 3 3 3 3 3 3 3 3 30 7 7 7 7 7 7 7 7 7 7 7 6 22 7 7 7 7 7 7 7 7 7 7 20 7 7 7 17 22 7 7 7 7 6 7 7 7 7 23 26 7 6 7 7 7 7 7 7 7 7 7 7 7 7 7 7 7 7 7 24 7 7 7 7 7 17 6 7 17 7 30 3 3 3 3 3 3 3 3 3 32 3 3 3 
3 3 3 3 3 3 3 3 3 3 3 3 3 3 30 7 7 7 7 7 7 22 17 7 7 7 7 7 7 7 7 7 7 7 7 23 26 7 7 7 7 7 7 7 7 7 7 7 7 7 7 7 7 7 2 13 7 7 7 7 7 7 7 7 7 7 7 7 7 7 7 7 7 7 7 7 23 26 22 7 7 24 7 7 7 30 3 3 3 3 3 3 3 3 3 3 3 3 3 3 
3 3 3 3 3 3 3 32 3 3 9 3 3 30 7 7 7 7 7 7 6 7 7 7 7 7 7 7 7 7 7 6 22 7 7 2 13 7 7 7 7 7 7 7 7 7 7 7 7 7 22 7 7 7 12 29 7 7 7 7 7 7 7 7 7 7 7 7 7 7 7 7 24 7 7 7 2 13 7 7 7 7 7 7 7 30 3 3 3 9 3 9 3 3 3 3 3 3 3 3 
3 3 3 3 3 3 3 3 19 3 3 3 30 7 7 7 7 20 7 7 20 7 7 7 7 7 7 20 7 7 7 7 7 7 7 12 29 7 7 7 7 7 7 7 7 7 7 7 7 7 7 7 7 7 7 22 7 7 7 7 7 7 7 7 7 24 7 7 7 7 7 7 7 7 7 7 12 29 7 7 7 7 7 7 30 3 3 3 3 3 3 3 3 3 3 3 3 3 3 3 
3 3 3 3 3 3 3 3 3 3 3 30 7 6 7 20 6 17 7 22 7 7 7 7 7 7 7 7 22 22 7 7 6 22 7 7 7 7 7 7 7 7 7 7 7 7 7 7 7 7 7 7 7 7 7 7 7 7 7 7 7 7 7 7 7 7 7 7 7 7 7 7 7 7 7 17 7 7 6 7 7 7 7 6 30 3 3 3 3 3 3 3 3 3 3 3 3 3 3 3 
3 3 3 3 3 3 3 3 3 3 30 20 7 7 7 7 7 7 7 6 20 7 7 7 22 7 7 17 17 7 7 7 7 17 7 7 7 7 20 7 7 7 6 17 7 7 7 7 7 7 7 7 7 7 7 7 7 7 7 7 22 7 7 7 7 7 7 7 6 7 7 7 11 21 7 7 17 22 7 7 24 7 17 30 3 3 3 3 3 3 3 3 3 3 3 3 3 9 3 3 
3 3 3 3 3 3 3 3 3 30 7 7 7 7 7 7 7 7 20 7 22 17 20 22 17 7 7 7 7 7 7 7 7 7 7 7 7 7 7 7 7 7 7 7 7 7 7 7 7 6 17 7 7 7 7 7 7 7 7 7 6 7 7 7 7 6 7 7 22 7 7 7 10 4 7 7 7 7 7 22 7 7 7 30 3 3 3 3 32 3 3 3 3 9 3 3 3 9 3 3 
3 3 3 9 3 3 3 3 30 7 7 7 7 7 7 20 7 7 7 7 6 7 7 7 7 7 7 7 22 6 7 7 7 7 7 22 7 7 7 7 7 7 7 7 17 7 7 7 7 7 7 7 7 7 7 22 7 7 7 7 7 7 7 7 23 26 7 7 7 24 7 7 8 1 7 7 24 7 0 6 7 7 30 3 3 3 3 3 3 9 3 3 3 3 3 3 3 19 3 3 
3 32 3 9 3 3 3 3 30 7 6 20 7 7 7 7 7 6 7 17 7 7 7 7 7 7 7 7 7 6 20 7 7 7 7 7 7 7 7 7 7 7 7 7 7 7 7 7 7 7 7 17 17 7 7 6 17 7 7 7 7 7 7 7 2 13 7 7 7 7 7 7 7 7 7 7 7 7 7 17 7 30 3 3 3 3 3 3 3 3 3 3 3 3 3 3 3 3 3 3 
3 3 3 3 3 3 3 3 30 7 7 7 17 7 6 22 7 7 7 6 7 7 20 7 7 20 7 7 7 22 6 7 7 7 7 7 7 7 7 7 7 7 7 7 7 7 6 17 7 7 7 7 7 7 7 7 7 7 7 7 7 7 7 7 12 29 22 7 7 7 7 7 7 7 7 17 23 26 17 7 30 3 3 3 3 3 3 3 3 3 3 3 3 3 3 3 3 3 3 3 
3 3 3 3 3 3 3 3 30 7 7 20 7 7 7 6 7 0 7 7 20 7 7 7 7 7 7 7 7 7 7 7 22 6 7 7 7 7 7 7 7 7 7 7 7 7 7 7 7 7 7 7 7 7 7 7 7 7 7 7 7 7 7 7 7 7 7 7 6 7 7 24 7 7 7 7 2 13 7 7 30 3 3 3 3 3 3 3 3 3 3 3 3 3 3 3 3 3 3 3 
3 3 3 3 3 3 3 3 30 7 7 7 7 7 7 7 20 7 7 7 7 7 6 22 7 7 7 7 7 30 7 7 7 7 7 7 7 7 20 7 7 7 7 6 22 17 7 7 6 22 7 7 17 7 7 7 7 7 7 7 7 7 7 7 22 6 7 7 7 7 7 7 7 7 7 7 12 29 30 30 3 3 3 3 3 3 3 3 3 3 3 3 3 3 3 3 3 3 3 3 
3 32 3 3 3 9 3 3 3 30 7 7 20 7 7 7 17 7 7 7 7 20 22 6 7 7 20 7 30 3 30 30 30 7 7 7 7 7 7 7 7 7 7 7 7 7 7 7 7 7 7 7 7 7 7 17 7 7 7 7 7 7 7 7 7 7 24 7 7 7 7 7 7 24 7 7 30 30 3 3 3 3 3 3 9 3 3 3 3 3 3 3 32 3 3 3 3 3 3 3 
3 3 9 3 3 3 3 3 3 3 30 7 7 7 7 7 22 7 7 20 7 7 7 7 7 7 30 30 3 3 3 3 3 30 30 30 7 7 7 7 7 7 7 7 22 23 26 7 7 7 7 7 7 7 7 22 23 26 7 7 7 7 7 7 7 7 7 7 30 30 30 30 30 30 30 30 3 3 3 3 3 3 3 3 3 3 19 3 3 3 3 3 3 3 3 3 3 32 3 3 
3 3 3 3 3 3 3 3 3 3 3 30 7 7 20 7 7 7 7 7 7 7 7 7 20 30 3 3 3 3 3 3 3 3 3 3 30 30 7 7 7 7 7 7 7 2 13 7 7 17 6 7 7 7 7 7 2 13 7 7 7 7 7 7 7 7 7 30 3 3 3 3 3 3 3 3 3 3 3 3 3 3 3 3 3 3 3 3 3 3 3 3 3 3 3 3 3 3 3 3 
3 3 3 32 3 3 3 3 3 3 3 3 30 30 7 7 7 20 7 7 7 22 7 7 30 3 3 3 3 3 3 9 3 3 3 3 3 3 30 30 7 7 7 7 7 12 29 7 7 7 7 7 7 7 7 7 12 29 7 6 6 6 7 7 7 30 30 3 3 3 3 3 3 3 3 3 3 3 3 3 3 9 3 3 3 3 3 3 3 3 3 9 3 3 3 3 3 3 3 3 
3 3 3 3 3 3 3 3 19 3 3 3 3 3 30 30 30 30 7 7 20 7 7 30 3 3 3 3 3 3 3 3 3 3 3 3 3 3 3 3 30 30 7 7 7 7 7 7 7 7 7 7 7 7 6 7 7 7 7 17 7 30 30 30 30 3 3 3 3 3 3 3 3 3 3 3 3 3 3 3 3 3 3 3 3 3 3 3 3 3 3 3 3 3 3 3 3 3 3 3 
3 3 3 3 9 3 3 3 3 3 3 3 3 3 3 3 3 3 30 30 30 30 30 3 3 3 3 3 3 3 3 3 3 3 3 3 3 3 3 3 3 3 30 30 30 30 30 30 30 7 7 7 7 7 17 7 7 7 7 7 30 3 3 3 3 3 3 3 3 3 3 3 3 32 3 3 3 3 3 3 3 3 3 3 3 3 3 3 3 3 3 3 3 3 3 3 3 3 3 3 
3 3 3 3 3 3 3 32 32 3 3 3 3 3 3 3 3 3 3 3 3 3 3 3 3 3 3 3 19 3 9 3 3 3 3 3 3 3 19 3 3 3 3 3 3 3 3 3 3 30 30 30 30 30 30 30 30 30 30 30 9 3 3 3 3 3 3 3 3 19 3 3 3 3 9 3 3 3 3 3 3 3 3 3 3 32 3 3 3 3 3 3 3 3 3 3 3 3 3 3 
3 3 3 3 3 19 3 3 3 3 3 3 3 3 3 3 3 9 3 3 3 3 3 3 3 9 3 3 3 3 3 3 3 3 3 3 3 3 3 3 3 3 3 3 3 3 3 3 3 3 3 3 3 3 3 3 3 3 3 3 3 3 3 3 3 3 3 3 3 3 3 3 3 3 3 3 3 3 3 3 3 3 3 3 3 3 3 3 3 3 3 3 3 3 3 3 3 3 3 3 
3 3 3 3 3 3 3 3 3 3 3 3 32 32 3 3 3 19 3 3 3 3 3 3 3 3 3 3 3 3 3 3 3 3 3 3 3 3 19 3 3 3 3 3 3 3 3 3 3 3 3 3 3 3 3 3 3 3 3 3 3 3 3 3 3 3 3 3 3 3 3 3 3 3 3 3 3 3 3 9 3 9 3 3 3 3 3 3 3 3 3 3 3 3 3 3 3 3 3 3 
3 3 3 3 3 3 3 3 3 3 3 3 3 3 3 3 3 3 3 3 3 3 3 3 3 3 3 3 3 3 19 3 3 3 3 3 3 3 3 3 3 3 3 19 3 3 3 3 3 3 3 3 19 3 3 3 3 3 3 32 3 3 3 3 3 3 3 3 3 3 3 3 3 3 3 3 3 3 3 3 3 3 3 3 3 3 3 3 3 3 3 3 3 9 3 3 9 3 3 3 
3 3 3 3 3 3 3 3 3 3 3 3 3 3 3 3 3 32 3 3 3 3 3 3 3 3 3 3 3 3 3 3 3 3 3 3 3 3 3 3 3 3 19 3 3 3 32 3 9 3 3 3 3 3 3 3 3 3 9 3 3 3 3 3 3 3 19 3 3 3 9 3 3 3 3 3 32 3 3 3 3 3 3 3 3 3 9 3 3 3 3 3 3 3 3 3 3 3 3 3 
3 3 3 3 3 3 3 3 3 3 19 3 9 3 3 3 3 3 3 3 3 3 3 3 3 3 3 3 3 3 3 3 3 3 3 3 3 3 9 3 3 3 3 3 3 3 3 3 3 3 3 3 3 3 3 9 3 3 3 3 3 3 3 3 3 3 3 3 3 3 3 3 3 3 3 3 9 3 3 3 3 3 3 3 3 3 3 3 3 3 3 3 3 3 3 3 3 3 3 3 
3 9 32 3 3 3 9 3 3 3 32 32 3 3 3 3 3 3 3 3 9 9 19 3 9 3 3 3 3 3 3 3 9 3 3 3 3 3 3 3 3 3 3 3 3 3 3 9 3 3 3 3 3 3 3 3 3 3 3 3 3 3 3 3 3 3 3 3 3 3 3 3 3 3 3 3 3 3 3 3 3 3 3 9 3 3 3 3 3 3 9 3 3 3 3 32 3 3 3 3 
3 3 32 3 3 3 32 3 3 3 3 3 3 9 3 3 3 3 3 3 3 3 3 3 3 3 32 3 3 3 3 3 3 3 3 3 3 3 3 3 3 3 3 3 3 3 3 3 3 3 32 19 3 3 3 3 3 3 3 3 3 3 3 3 3 3 3 3 3 3 3 3 3 3 3 3 3 3 3 3 3 3 3 3 3 3 3 3 3 3 3 3 3 3 3 3 3 3 3 3 
3 3 3 3 3 3 3 3 3 3 3 3 3 19 3 3 3 3 3 3 3 32 3 3 3 3 3 3 3 3 3 3 3 3 3 3 3 3 32 9 3 3 3 3 3 3 3 3 3 3 9 3 3 3 3 3 3 3 3 3 32 3 3 3 3 3 3 19 3 3 3 3 3 19 3 3 3 19 3 3 9 3 3 19 3 3 3 3 3 3 3 3 3 3 3 3 3 3 3 3 
3 3 3 3 3 3 3 3 3 3 3 3 32 3 3 3 3 3 3 3 3 3 3 3 3 3 3 3 3 3 3 3 3 3 3 3 3 3 3 3 3 3 3 3 3 3 3 3 3 3 3 3 3 3 3 3 3 3 3 9 3 3 3 3 3 3 3 3 3 3 3 3 3 3 3 3 3 3 3 3 3 3 3 3 3 3 3 32 9 9 3 3 3 3 3 3 3 3 3 3 